22222222222222222222222222222222222222222222222222222222222222222222222222222222222222222222222222222222222222222222222222222222
22222222222222222222222222222222222222222222222222222222222222222222222222222222222222222222222222222222222222222222222222222222
22222222222222222222222222222222222223322222222222333322222222222222222222222222222222222222222222222222222222222222222222222222
22222222222222222222222222233333333333333333333333333333333333222222223333333333333333333333333333322222222222222222222222222222
22222222222222222222333333333333333333333333333333333333333333222223333333333333333333333333333333333332222222222211111112222222
22222222222222222223333333333333333332222333333333333333333332222222333333333333333333333333333333333333111111111111111111111112
11111222222222222223333333333333333333332233333333333333322222222222233333333333333333333333333331131111111111111111111111111111
11111111111111111133333333333333333333333233333333333333222222222222223333333333333333333333333333333331111133311111111111333331
11111133333331333333333333333333333333333323333333333322222222222223333333333333333333333333333333331111111133311111111111113331
11331111111111111111333333333333333333333332333333332221122222222333333333333333331333311111113333331111111133111111111111111111
51111111133333333333333333333333333333333322233332222211111122333333333333333331111331111111111111111111111111111111111111133335
51111133133333333333333333333333333333333222222222222222222223333333333333333331111111111111111111111111111111111111115511555555
55533333333555555333333333333333333333333332222222225555555233333333333333333111111111111111111111111111111111111115555115555555
55553333355555555333333333333333333333333333322222555555555523333113333333311111111111111111111111111111111111111115555155555555
55555555555555555533333333333333333333333333322225555555555522211111111111111111111111111111111111111111111111111115555155555555
55555555555555555555333333333333333333333333322255555555555552211111111111111111111111111111111111111111111111111111555555555555
55555555555555555555111313113331333333333222255555555555555555511111111111111111111111111111111111111111111111115111555555555555
55555555555555555555131111111131333333333222255555555555555511111555151111111111111111111111111111111111111111155115555555555555
55555555555555555555131111111111111111555555555555555555555511155515515111111111111111111111111111111111111111555115555555555555
55555555555555555555513111111111111115555555555555555555555551551115555551111111111111111111111111111111111111555155555555555555
55555555555555555555511111111111111155555555555555555555555511111111555555551111111111111111111111111111111111511155555555555555
55555555555555555555555111111155511155555555555555555555555111111111111111111111111111111111111111111111111111155555555555555555
55555555555555555555555511111555511155555555555555555555555111111111111111111111111111111111111111111111111115555555555555555555
55555555555555555555555551111551155555555555555555555555551111111111111111115111115151111111111111111111111155555555555555555555
55555555555555555555555555111551155555555555555555555555551111111111111111115111111155551111111111111111111555555555555555555555
55555555555555555555555555111511115555555555555555555555511111111111111111111511111155555111115551111155555555555555555555555555
55555555555555555555555555551151111555555555555555555555511111111111111111111151115555555111155551111155551555555555555555555555
55555555555555555555555555555555515555111155555555555555511111111111111111111151555555555511555555111115551555555555555555555555
55555555555555555555555555555555551111115555555555555555555111111111111111111115115555555511555555111155555155555555555555555555
55555555555555555555555555555555551111111111115555555555555551111111111111111111155555555551155555111115515515555555555555555555
55555555555555555555555555555555555111111111111155555555555555515111111111111111155555555555555555511155515515555555555555555555
55555555555555555555555555555555555111111111111155555555555555555551111111111111555555555555555555111111155555555555555555555555
55555555555555555555555555555555555111111111111111555555555555555551111111141115555555555555555555511111155555555555555555555555
55555555555555555555555555555555555111111111111111115555555555555551111111111155555555555555555555511111151555511155555555555555
55555555555555555555555555555555555131111111111111115555555555555555111111111155555555555555555555555555111155511111555555555555
55555555555555555555555555555555555131111111111111115555555555555555111111111155555555555555555555555555111551111115555555555555
55555555555555555555555555555555555513111111111111155555555555555555111111111155555555555555555555555555555511111111115555555555
55555555555555555555555555555555555555313111111111555555555555555555111111111155155555555555555555555555555111111115555555555555
55555555555555555555555555555555555555313111111111555555555555555555111111111551155555555555555555555555555111111111555555555555
55555555555555555555555555555555555555113111111111555555555555555555111111115551155555555555555555555555551111111111155555555555
55555555555555555555555555555555555555111111111115555555555555555555111111115551155555555555555555555555111111111111115555555555
55555555555555555555555555555555555555111111111555555555555555555555511111115555555555555555555555555555111111111111115555555555
55555555555555555555555555555555555555111111111555555555555555555555511111155555555555555555555555555555111111111111115555555555
55555555555555555555555555555555555555111111115555555555555555555555551111555555555555555555555555555555111111111111115555555555
55555555555555555555555555555555555555111111155555555555555555555555551115555555555555555555555555555555111555511111155555555555
55555555555555555555555555555555555551111111155555555555555555555555555555555555555555555555555555555555555555555111155555555155
55555555555555555555555555555555555551111115555555555555555555555555555555555555555555555555555555555555555555555511555555555115
55555555555555555555555555555555555551111115555555555555555555555555555555555555555555555555555555555555555555555551555555551555
55555555555555555555555555555555555551111155555555555555555555555555555555555555555555555555555555555555555555555555555555555555
55555555555555555555555555555555555553111155555555555555555555555555555555555555555555555555555555555555555555555555555555555555
55555555555555555555555555555555555553111111555555522222222222255555555555555555555555555555555555555555555555555555555555555555
55555555555555555555555555555555555555111555522222222222222222222222255555555522222222222222222222222222222222222222555555555555
55555555555555555555555555555555555555555552222222222222222222222222222222222222222222222222222222222222222222222222555555555555
22222222222222255555555555555555555555555222222222222222222222222222222222222222222222222222222222222222222222222222222222222222
22222222222222222222222222222222222222222233222222222222222222222222222222222222222222222222222222222222222222222222222222222222
22222222222222222222222222222222222223333333222222222222222222222222222222222233333333333333333333333333333333333333332222222222
22222222222222222222222222222222233333333333222222222222222222233333333333333333333333333333333333333333333333333333333222222222
22222222222222222222222223333333333333333333332222222222222333333333333333333333333333333333333333333333333333333333333333322222
22222222222222222333333323333333333333333333333222222222333333333333333333333333333333333333333333333333333333333333333333333333
33333333333333333333333333333333333333333333333333333333333333333333333333333333333333333333333333333333333333333333333333333333
33333333333333333333333333333333333333333333333333333333333333333333333333333333333333333333333333333333333333333333333333333333
33333333333333333333333333333333333333333333333333333333333333333333333333333333333333333333333333333333333333333333333333333333
33333333333333333333333333333333333333333333333333333333333333333333333333333333333333333333333333333333333333333333333333333333
33333333333333333333333333333333333333333333333333333333333333333333333333333333333333333333333333333333333333333333333333333333
33333333333333333333333333333333333333333333333333333333333333333333333333333333333333333333333333333333333333333333333333333333
